AAAAAAAAAAAAASAA
AAAAAAAAAAAAASAA
AAAAAAAAAAAAASAA
AAAAAAAAAAAAASAA
GGBCGGGGGGGGGMGG
AAAJKLAAAAAAASAA
GGGNOHIGBCGGGMGG
APQRAAAAAJKLASAA
TUGBCGGGGGGHIMGG
AAAAJKLAAAAAASAA
GGGGGGHIGGGGGMGG
AAAAAAAAAAAAASAA
AAAAAAAAAAAAASAA
AAAAAAAAAAAAASAA
AAAAAAAAAAAAASAA
