AAAAAAAAAAAAASAA
AAAAAAAAAAAAASAA
AAAAAAAAAAAAASAA
AAAAAAAAAAAAASAA
AAAAAAAAAAAAASAA
GGBCGGGGGGGGGMGG
AAAJKLAAAAAAASAA
GGGNOHIGBCGGGMGG
APQRAAAAAJKLASAA
TUGGGGGGGGGHIMGG
AAAAAAAAAAAAASAA
AAAAAAAAAAAAASAA
AAAAAAAAAAAAASAA
AAAAAAAAAAAAASAA
AAAAAAAAAAAAASAA
