AAAAAAAAAAAAASAA
AAAAAAAAAAAAASAA
AAAAAAAAAAAAASAA
BCGGGGGGGGGGGMNO
AJKLAAAAAAAAPXRA
GGGHINOGBCGTUMGG
AAAPQRAAAJKLASAA
BCTUGGGGGGGHIMNO
AJKLAAAAAAAAPXRA
GGGHINOGBCGTUMGG
AAAPQRAAAJKLASAA
GGTUGGGGGGGHIMGG
AAAAAAAAAAAAASAA
AAAAAAAAAAAAASAA
AAAAAAAAAAAAASAA
