AAAAAAAAAAAAASAA
AAAAAAAAAAAAASAA
AAAAAAAAAAAAASAA
AAAAAAAAAAAAASAA
AAAAAAAAAAAAASAA
GGBCGGGGGGGGGMGG
AAAJKLAAAAAAASAA
AAFGGHINOGGGGMGG
AAAAAPQRAAAAASAA
GGGGTUGGGGGGGMGG
AAAAAAAAAAAAASAA
AAAAAAAAAAAAASAA
AAAAAAAAAAAAASAA
AAAAAAAAAAAAASAA
AAAAAAAAAAAAASAA
