AAAAAAAAAAAAASAA
AAAAAAAAAAAAASAA
AAAAAAAAAAAAASAA
AAAAAAAAAAAAASAA
AAAAAAAAAAAAASAA
GGBCGGGGGGGGGMGG
AAAJKLAAAAAAASAA
AAFGGHIGGGGGGMGG
AAAAAAAAAAAAASAA
AAAAAAAAAAAAASAA
AAAAAAAAAAAAASAA
AAAAAAAAAAAAASAA
AAAAAAAAAAAAASAA
AAAAAAAAAAAAASAA
AAAAAAAAAAAAASAA
